1111111111
10001000E1
10P0110001
10000C0001
1111111111